.
                                                                         ssssssssssssssssssssssssssssss
-------------------------------------------------------------------------------------------------------
                                                                         ##############################
                                                  
                                                                              SSS       SSS       SSS  
                                                                             S   S     S   S     S   S 
                                                                            S     S   S     S   S     S
                                                                         SSS       SSS       SSS       
                                                                                                       
                                                                                                       
                                                  
                                                               ####          ########                  
                                                       ##     ######       ############      ##########
                                                     #################   ##############################
                                                  #####################################################
-----
L
