                
                                                f     f
                                                      f
------------------------------------------------------------------------------------------------------------
                                       #####################################################################
                                                               #######                  I   ########
                                                                  I                                    
                                                                             I                           
                                                                         #####                              
                                                                       #########                          
                                                                         #####                             
                                                                           I                        
                               I            I
                             ####          ########                   
                     ##     ######       ############      ##############                   
                   #################   ########################################          ########
                ############################################################################################
-----
L
8
