                                                     f                                                                                                                                                                                                                                                                                                                                                                                                                                                                                                                                
                                                     f                                                 f                                  f   F                                                                                                                s                 ss                                                                                                                                                                                                                                                                                                   
                                                                                                                                              F                                                                                                                 sssssss     sssss                                                                                                                                FF                                                                                                                                                                   
                                                                                                                                                                                                                                                F                      sssss                                                                                                                                      F                                                                                                                                                                   
--------------------------------------------------------------------------------------------------------------------------------------------------------------------------------------------------------------------------------------------------------------------------------------------------------------------------------------------------------------------------------------------------------------------------------------------------------------------------------------------------------------------------------------------------------------------------------------
                                                                ######################################################################################################                                                               #################################################################################################################################################################################################################################################################################################################################################
                                                                    #######                                  ############         #####                  ####                                                                            ###########            #################                               ####################                         ##################################################################################### ### ### ### ### ### ### ### ### ### ### ### ### ### ### ### ### ### ### ### ### ### ### ### ### ### ### ### ### ### ### ### ### ###
                                                                     #                                   <                                                                                               S S S S                                ##                     #####                                        ############                               ##############                                                         #   ########  ##  ##  ##  ##  ##  ##  ##  ##  ##  ##  ##  ##  ##  ##  ##  ##  ##  ##  ##  ##  ##  ##  ##  ##  ##  ##  ##  ##  ##  ##  ##  ##  ##
                                                     <                                                 <                                      <                 <                                                                                                                                                           +                                     #########                                                            ########### ### ### ### ### ### ### ### ### ### ### ### ### ### ### ### ### ### ### ### ### ### ### ### ### ### ### ### ### ### ### ### ### ###
                                                   <                     S   ###                         <                                  <                             n                                                                                         SSS       SSS                                           +                                      #######                                                                ############################################################################################################################################
                                                     <                      #####                   ##                                    <                             n              S S S S                                                  <                  S   S     S   S                                          +               K                       +   +           K                             <                       +++                                                                                                                                         
                                                                             ###                 ########                                   <                         n                                                                                           S     S   S     S                                         +                                       +   +                                        <                        +++                                                                                                                                         
                                                                         S                         ######                                     <                     n                                                       S S S S                            SSS       SSS                                                +                                       +   +                                         <                       +++                                                                                                                                         
                                                                                    #####                                                                       <                                                                                                                                                          ###                                     #######                                                                ############################################################################################################################################
                                         ###                                       ########                                        ####                                                                                                                                                                                ############                          ################                                                          ########### ### ### ### ### ### ### ### ### ### ### ### ### ### ### ### ### ### ### ### ### ### ### ### ### ### ### ### ### ### ### ### ### ###
                          ##            #####    ######                             ############                             I    #############      ########                          ###      #########         ##########               #####    ######    #                 ###       ######              ##########################################################################                                              #   ########  ##  ##  ##  ##  ##  ##  ##  ##  ##  ##  ##  ##  ##  ##  ##  ##  ##  ##  ##  ##  ##  ##  ##  ##  ##  ##  ##  ##  ##  ##  ##  ##  ##
             ####     ###########     ###################         ###########################################             #########################################               ###################################################################################      #########   #################      #################################################################################################################################### ### ### ### ### ### ### ### ### ### ### ### ### ### ### ### ### ### ### ### ### ### ### ### ### ### ### ### ### ### ### ### ### ###
     #################################################################################################################################################################################################################################################################################################################################################################################################################################################################################################################################################################################
--------------------------------------------------------------------------------------------------------------------------------------------------------------------------------------------------------------------------------------------------------------------------------------------------------------------------------------------------------------------------------------------------------------------------------------------------------------------------------------------------------------------------------------------------------------------------------------
8                                                                                                                                                                                                                                                   7       6                                                                                                7                         8                                                                                    7       6      5      4      3      2       1     0                                                       
