.                                                                                                                       f                                           f   f              F                                                                 fffffffffffFffffffffffffffffFffffFfffffffffffffFFfffffff                                   F   f                                                                  .                                                                                                   
.                                                                                                                                                                       f                                                                                F   ffffffffffffffffffFfffffffffffffffffffffffffffffffff                                   F   f.                                                                .                                                                              F                     
.                                                                                                                                                                                                                                                                                                                                                                                                                          .                                                                             F            f        
.                                                                                                                                                                                                                                                                                                                                                                                                                          .                                                                                          f        
.                                                                                                                                                                                                                                                                                                                                                                                                                                                                                                                     f        
.                                                                                                                                                                                                                                                                                                                                                                                                                                                                                                                     f        
---------------------------------------------------------------------------------------------------------------------------------------------------------------------------------------------------------------------------------------------------------------------------------------------------------------------------------------------------------------------------------------------------------------------------------------------------------------------------------------------------------------------------------------------------------------------------------------------------------------------------------------------------------------------------------------------------------------------------------
##############################################################                                                                            #        #        #                                                                                                                     <                  <                                                                                          #             #      #               #       #             #   #  #   #   #   #   #   #   #   #   #   #   #   #   #   #   #   #                 #       #       #                  ##############################################################################################################################################
## ### ### ### ### ### ### ### ### ### ### ### ### ### ### ####                                                                           #        #        #                                                                                            <            <                      <                                                          <                                       ###############      #               #       #             #   #  #############################################################                 #       #       ############################# ### ### ### ### ### ### ### ### ### ### ### ### ### ### ### ### ### ### ### ### ### ### ### ### ### ### ### ### ### ### ### ### ###
##  ##  ##  ##  ##  ##  ##  ##  ##  ##  ##  ##  ##  ##  ##  ####                                                          <              #####################                                                                 <                                                     <                 <                                              <                                         #      #      #   #######################    ###############   ####                                                   <        ##################       #########                ############  ##  ##  ##  ##  ##  ##  ##  ##  ##  ##  ##  ##  ##  ##  ##  ##  ##  ##  ##  ##  ##  ##  ##  ##  ##  ##  ##  ##  ##  ##  ##  ##  ##
## ### ### ### ### ### ### ### ### ### ### ### ### ### ### ####                                                         <                    I#        #                                                                     <                                <             <                     <                                                 <                                       #######################          I          #    #             #    #                                                   <                                             ###           ############# ### ### ### ### ### ### ### ### ### ### ### ### ### ### ### ### ### ### ### ### ### ### ### ### ### ### ### ### ### ### ### ### ###
##############################################################                                                            <                   #        #                                                                   <                                        <           <                           <                                     <                                                    I                                #########################                                                     <                                   ###    ##  ###       ##################################################################################################################################################
                                                                                                                                             ############                                             SSSSS              <                                              <                   <            <                                          <                                                                                               I                                                    <                                               ## ################################                                                                                                                                     
                                                                                                                 I                                     I                                                                   <                                  <           <          <            <                                                   <                                         +            +                               +            +                                 K          <                K                                ################################                                                                                                                                        
                                                                                                       ############                                                     <                                                    <                                                 <                       <                                                <                                                                                           I                                                    <                                                  I   I   I  ########                                                                                                                                                  
##############################################################                                          #        #                                                    <                                                        <                                        <                     <            <                                                                                           I                                #########################                                                     <                                                    ##               #####################################################################################################################################
## ### ### ### ### ### ### ### ### ### ### ### ### ### ### ####                                        I#        #                                                  <                                                                                    <                  <           <                                                      ###############                              #######################          I          #    #             #    #                                                   <                                                       #              ## ### ### ### ### ### ### ### ### ### ### ### ### ### ### ### ### ### ### ### ### ### ### ### ### ### ### ### ### ### ### ### ### ###
##  ##  ##  ##  ##  ##  ##  ##  ##  ##  ##  ##  ##  ##  ##  ####                                 #######################                                              <                                                                                         <                <              <        <                                      #           #                                   #      #      #   #######################    ###############   ####                                                   <                                    #############              #######  ##  ##  ##  ##  ##  ##  ##  ##  ##  ##  ##  ##  ##  ##  ##  ##  ##  ##  ##  ##  ##  ##  ##  ##  ##  ##  ##  ##  ##  ##  ##  ##  ##
## ### ### ### ### ### ### ### ### ### ### ### ### ### ### ####                                    #        #        #                                                  <                                                                                                  <                <                                              ######################                               ###############      #               #       #      #      #   #  #############################################################                                 #########            ######## ### ### ### ### ### ### ### ### ### ### ### ### ### ### ### ### ### ### ### ### ### ### ### ### ### ### ### ### ### ### ### ### ###
##############################################################                                     #        #        #                                                                 <                                                                            <          <                   <                                        #                  #                                #             #      #               #       #      #      #   #  #   #   #   #   #   #   #   #   #   #   #   #   #   #   #   #                                     #############################################################################################################################################################
---------------------------------------------------------------------------------------------------------------------------------------------------------------------------------------------------------------------------------------------------------------------------------------------------------------------------------------------------------------------------------------------------------------------------------------------------------------------------------------------------------------------------------------------------------------------------------------------------------------------------------------------------------------------------------------------------------------------------------
1                                                                2         3      4    5  6                                                                                                                                                                                                                                                                                    7       8                                                                                                                                                                                                                               7       6      5      4      3      2       1     0                                                       
